_1 _1 _6 _6 _6 E6 _6 _6 _1 _1 _1 _1 _1 _1 _1 _1 _1 _1 _1 _1 _1 _1 _1 _1
_1 _1 _6 _6 _6 R6 _6 _6 _1 _1 _1 _1 _1 _1 _1 _1 _1 _1 _1 _1 _1 _1 _1 _1
_1 _1 _6 _6 _6 R6 _6 _6 _1 _1 _1 _1 _1 _1 _1 _1 _6 _6 _6 _6 _6 _6 _1 _1
_1 L1 _6 _6 _6 R6 _6 L6 _1 _1 _1 _19 _1 _1 _1 _1 _6 _6 _6 _14 _6 _6 _1 _1
_1 _1 _6 _6 _6 R6 _6 _6 _1 _1 _1 _1 _1 _1 _1 _1 _6 _6 _6 _6 _6 _6 _1 _1
_1 _1 _6 _6 _6 R6 _6 _6 _1 _1 _19 _1 _1 _1 _1 _1 L6 _6 _6 _6 _6 _6 L1 _1
_1 _1 _6 _6 _6 R6 _6 _6 _1 _1 _1 _1 _1 _1 _1 _1 _6 _6 _6 _6 _6 _6 _1 _1
_1 _1 _6 _6 _6 R6 _6 _6 _1 _1 _1 _1 _19 _1 _1 _1 _6 _6 _6 _6 _6 _6 _6 _6
_1 _1 L6 _6 _6 R6 _6 _6 L1 _1 _1 _1 _1 _1 _1 _1 _6 _6 _6 _6 _6 _6 _6 _6
_1 _1 _6 _6 _6 R6 _6 _6 _1 _1 _1 _1 _1 _1 _1 _1 _6 _6 _6 R6 R6 R6 S6 _6
_1 _1 _6 _6 _6 R6 _6 _6 _6 L6 _6 _6 _6 _6 _6 _6 _6 _6 _6 R6 _6 _6 _6 _6
_1 _1 _6 _6 _6 R6 _6 _6 _6 _6 _6 _6 _6 _6 _6 _6 _6 _6 _6 R6 _6 _6 _1 _1
_1 _1 _6 _6 _6 R6 R6 R6 R6 R6 R6 R6 R6 R6 R6 R6 R6 R6 R6 R6 _6 _6 _1 _1
_1 _1 _6 _6 _6 _6 _6 _6 _6 _6 _6 _6 _6 _6 _6 _6 _6 M6 _6 _6 _6 _6 _1 _1
_1 _1 _6 M6 _6 _6 _6 _6 _6 _6 _6 _6 _6 _6 _6 _6 _6 _6 _6 _6 _6 _6 _1 _1
_1 _1 _6 _6 _6 _6 _6 _6 _6 L6 _6 _6 _6 _6 _6 _6 _6 _6 _6 _6 _6 _6 _1 _1
_1 _1 _1 _1 _1 _1 _1 _1 _1 _1 _1 _1 _1 _1 _1 _1 _1 _1 _1 _1 _1 _1 _1 _1
_1 _1 _1 _1 _1 _1 _1 _1 _1 _1 _1 _1 _1 _1 _1 _1 _1 _1 _1 _1 _1 _1 _1 _1