_6 S6 _6 _6 _5 _5 _5 _5 _5 _5 _5 _5 _5 _6 _6 _6 _5 _5 _5 _5 _5 _5 _5 _5
_6 R6 _6 _6 _5 _5 _5 _5 _5 _5 _5 _5 _5 _6 _6 _6 _5 _5 _5 _5 _5 _5 _5 _5
_6 R6 _6 C6 _5 _5 _5 _5 _5 _5 _5 _5 _5 _6 _6 _6 _5 _5 _5 _5 _5 _5 _5 _5
_6 R6 _6 _6 _5 _5 _5 _5 _5 _5 _5 _5 _5 _5 _6 _5 _5 _5 _5 _5 _5 _5 _5 _5
_6 R6 _6 _6 _6 _6 _6 _6 _6 _6 _6 _6 _5 C6 _6 C6 _5 _6 _6 _6 _6 _6 _6 _6
_6 R6 _6 _6 _6 _6 _6 _6 _6 _6 _6 _6 _6 _6 _6 _6 _6 _6 _6 _6 _6 _6 _6 _6
_6 R6 R6 R6 R6 R6 R6 R6 R6 R6 R6 R6 R6 R6 R6 R6 R6 R6 R6 R6 R6 R6 R6 E6
_6 _6 _6 _6 _6 _6 _6 _6 _6 _6 _6 M6 _6 _6 _6 _6 _6 _6 _6 _6 _6 _6 _6 _6
_5 _6 _6 _6 _6 _6 _6 _6 _6 _6 _6 _6 _6 _6 _6 _6 _6 _6 _6 _6 _6 _6 _6 _6
_6 _6 _6 _6 _6 C6 _6 _6 _6 _6 _6 _6 _6 _6 _6 _6 _6 _6 _6 _6 _6 _6 _6 _6
_6 _6 _6 C6 _5 _6 _6 _6 _6 _6 _6 _6 _6 _6 C6 _6 _6 _6 _6 _5 C6 _6 _6 _6
_6 _6 _6 _5 _5 _5 _5 _5 _5 _5 _5 _5 _5 _5 _5 _5 _5 _5 _5 _5 _5 _6 _5 _5
_6 _6 _6 _6 _5 _5 _5 _5 _5 _5 _5 _5 _5 _5 _5 _5 _5 _5 _5 _5 _5 _5 _5 _5
_6 _6 _6 C6 _5 _5 _5 _5 _5 _5 _5 _5 _5 _5 _5 _5 _5 _5 _5 _5 _5 _5 _5 _5
_6 _6 _6 _6 _5 _5 _5 _5 _5 _5 _5 _5 _5 _5 _5 _5 _5 _5 _5 _5 _5 _5 _5 _5
_6 _6 _6 _6 _5 _5 _5 _5 _5 _5 _5 _5 _5 _5 _5 _5 _5 _5 _5 _5 _5 _5 _5 _5
_6 _6 _6 _6 _5 _5 _5 _5 _5 _5 _5 _5 _5 _5 _5 _5 _5 _5 _5 _5 _5 _5 _5 _5
_6 _6 _6 _6 _5 _5 _5 _5 _5 _5 _5 _5 _5 _5 _5 _5 _5 _5 _5 _5 _5 _5 _5 _5
_6 _6 _6 _6 _5 _5 _5 _5 _5 _5 _5 _5 _5 _5 _5 _5 _5 _5 _5 _5 _5 _5 _5 _5
_6 _6 _6 _6 _5 _5 _5 _5 _5 _5 _5 _5 _5 _5 _5 _5 _5 _5 _5 _5 _5 _5 _5 _5
_6 _6 _6 _6 _5 _5 _5 _5 _5 _5 _5 _5 _5 _5 _5 _5 _5 _5 _5 _5 _5 _5 _5 _5
_6 _6 _6 _6 _5 _5 _5 _5 _5 _5 _5 _5 _5 _5 _5 _5 _5 _5 _5 _5 _5 _5 _5 _5
_6 _6 _6 _6 _5 _5 _5 _5 _5 _5 _5 _5 _5 _5 _5 _5 _5 _5 _5 _5 _5 _5 _5 _5
_6 _6 _6 _6 _5 _5 _5 _5 _5 _5 _5 _5 _5 _5 _5 _5 _5 _5 _5 _5 _5 _5 _5 _5
