_1 _1 _1 _1 _1 _1 _1 _1 _1 _1 _1 _1 _1 _1 _1 _1 _1 _1 _6 S6 _6 _1 _1 _1
_1 _6 _6 _6 _6 _6 _6 _6 _6 _6 L6 _6 _6 _6 _6 _6 _6 _6 _6 R6 _6 _6 _6 _1
_1 _6 _14 _6 _6 _6 _6 _6 _6 _6 _6 _6 _6 _6 _6 _6 _6 _6 _6 R6 _6 _14 _6 _1
_1 _6 _6 _6 _6 _6 _6 _6 _6 _6 _6 _6 _6 _6 _6 _6 _6 _6 _6 R6 _6 _6 _6 _1
_1 _6 _6 _6 _6 _6 _6 _6 _6 _6 _6 _6 _6 _6 _6 _6 _6 _6 _6 R6 _6 _6 _6 _1
_1 _6 _6 _6 _6 _6 _6 _6 _6 _6 _6 _6 _6 _6 _6 _6 _6 _6 _6 R6 _6 _6 _6 _1
_1 _6 _6 _6 _6 _6 _6 _6 _6 _6 _6 _6 _6 _6 _6 _6 _6 _6 _6 R6 _6 _6 _6 _1
_6 _6 _6 _6 _6 _6 _6 _6 _6 _6 _6 _6 _6 _6 _6 _6 _6 _6 _6 R6 _6 _6 _6 _1
_6 _6 _6 _6 _6 _6 _6 _6 _6 _6 _6 _6 _6 _6 _6 _6 _6 _6 _6 R6 _6 _6 _6 _1
E6 R6 R6 R6 R6 R6 R6 R6 R6 R6 R6 R6 R6 R6 R6 R6 R6 R6 R6 R6 _6 _6 _6 _1
_6 _6 _6 _6 _6 _6 _6 _6 _6 _6 _6 _6 _6 _6 _6 _6 _6 _6 _6 _6 _6 _6 _6 _1
_1 _6 _6 _6 _6 _6 _6 _6 _6 _6 _6 _6 _6 _6 _6 _6 _6 _6 _6 _6 _6 _6 _6 _1
_1 _6 _6 _6 _6 _6 _6 _6 _6 _6 _6 _6 _6 _6 _6 _6 _6 M6 _6 _6 _6 _6 _6 _1
_1 _6 _6 _6 _6 _6 _6 _6 _6 _6 _6 _6 _6 _6 _6 _6 _6 _6 _6 _6 _6 _6 _6 _1
_1 _6 _6 _6 _6 _6 _6 _6 _6 _6 _6 _6 _6 _6 _6 _6 _6 _6 _6 _6 _6 _6 _6 _1
_1 _6 _14 _6 _6 _6 _6 _6 _6 _6 _6 _6 _6 _6 _6 _6 _6 _6 _6 _6 _6 _14 _6 _1
_1 _6 _6 _6 _6 _6 _6 _6 _6 _6 L6 _6 _6 _6 _6 _6 _6 _6 _6 _6 _6 _6 _6 _1
_1 _1 _1 _1 _1 _1 _1 _1 _1 _1 _1 _1 _1 _1 _1 _1 _1 _1 _1 _1 _1 _1 _1 _1