_1 _1 _1 _1 _1 _1 _1 _1 _1 _1 _1 _1 _1 _1 _1 _1 _1 _1 _1 _1 _1 _1 _1 _1
_1 _1 _1 _19 _1 _1 _1 _1 _1 _1 _1 _1 _1 _1 _1 _1 _1 _1 _1 _1 _1 _1 _1 _1
_1 _1 _1 _1 _1 _1 _1 _1 _1 _1 _1 _1 _1 _1 _1 _1 _1 _1 _1 _1 _1 _1 _1 _1
_1 _1 _1 _1 _1 _1 _1 _1 _1 _1 _1 _1 _1 _1 _19 _1 _1 _1 _1 _1 _1 _1 _1 _1
_1 _1 _1 _1 _1 _1 _6 C6 _6 _6 C6 _6 _1 _1 _1 _1 _6 C6 _6 _6 C6 _6 _1 _1
_6 _6 _6 _6 _6 _6 _6 _6 _6 _6 _6 _6 _6 _6 _6 _6 _6 _6 _6 _6 _6 _6 _6 _6
_6 _6 _6 _6 _6 _6 _6 _6 _6 _6 _6 _6 _6 _6 _6 _6 _6 _6 _6 _6 _6 _6 _6 _6
_6 _6 _6 _6 _6 _6 _6 _6 _6 _6 _6 _6 _6 _6 _6 _6 _6 _6 _6 _6 _6 _6 _6 _6
S6 R6 R6 R6 R6 R6 R6 R6 R6 R6 R6 R6 R6 R6 R6 R6 R6 R6 R6 R6 R6 R6 R6 E6
_6 _6 _6 _6 _6 _6 _6 _6 _6 _6 _6 _6 _6 _6 _6 _6 _6 _6 _6 _6 _6 _6 _6 _6
_6 _6 _6 _6 _6 _6 _6 _6 _6 _6 _6 _6 _6 _6 _6 _6 _6 _6 _6 _6 _6 _6 _6 _6
_6 _6 _6 _6 _6 _6 _6 _6 _6 _6 _6 _6 _6 _6 _6 _6 _6 _6 _6 _6 _6 _6 _6 _6
_6 _6 _6 _6 _6 _6 _6 _6 _6 _6 _6 _6 _6 _6 _6 _6 _6 _6 _6 _6 _6 _6 _6 _6
_1 _1 _1 _1 _1 _1 _6 C6 _6 _6 C6 _6 _1 _1 _1 _1 _6 C6 _6 _6 C6 _6 _1 _1
_1 _1 _1 _1 _1 _1 _1 _1 _1 _1 _1 _1 _1 _1 _1 _1 _1 _1 _1 _1 _1 _1 _1 _1
_1 _1 _1 _1 _1 _1 _1 _1 _1 _1 _1 _1 _1 _1 _1 _1 _1 _1 _1 _1 _1 _19 _1 _1
_1 _1 _1 _1 _1 _1 _1 _1 _1 _1 _1 _1 _1 _1 _1 _1 _1 _1 _1 _1 _1 _1 _1 _1
_1 _1 _1 _1 _1 _1 _1 _1 _1 _1 _1 _1 _1 _1 _1 _1 _1 _1 _1 _1 _1 _1 _1 _1
