F RF  F  F  W  W  W  W  W  W  W  W  W  F  F  F  W  W  W  W  W  W  W  W
 F RF  F  F  W  W  W  W  W  W  W  W  W  F  F  F  W  W  W  W  W  W  W  W
 F RF  F  F  W  W  W  W  W  W  W  W  W  F  F  F  W  W  W  W  W  W  W  W
 F RF  F  F  W  W  W  W  W  W  W  W  CW F  F  F  W  W  W  W  W  W  W  W
 F RF  F  F  F  F  F  F  F  F  F  F  F  F  F  F  F  F  F  F  F  F  F  F
 F RF  F  F  F  F  F  F  F  F  F  F  F  F  F  F  F  F  F  F  F  F  F  F
 F RF RF RF RF RF RF RF RF RF RF RF RF RF RF RF RF RF RF RF RF RF RF RF
 F  F  F  F  F  F  F  F  F  F  F  F  F  F  F  F  F  F  F  F  F  F  F  F
 F  F  F  F  F  F  F  F  F  F  F  F  F  F  F  F  F  F  F  F  F  F  F  F
 F  F  F  F  F  F  F  F  F  F  F  F  F  F  F  F  F  F  F  F  F  F  F  F
 F  F  F  F  F  F  F  F  F  F  F  F  F  F  F  F  F  F  F  F  F  F  F  F
 F  F  F  F  W  W  W  W  W  W  W  W  W  W  W  W  W  W  W  W  W  W  W  W
 F  F  F  F  W  W  W  W  W  W  W  W  W  W  W  W  W  W  W  W  W  W  W  W
 F  F  F  F  W  W  W  W  W  W  W  W  W  W  W  W  W  W  W  W  W  W  W  W
 F  F  F  F  W  W  W  W  W  W  W  W  W  W  W  W  W  W  W  W  W  W  W  W
 F  F  F  F  W  W  W  W  W  W  W  W  W  W  W  W  W  W  W  W  W  W  W  W
 F  F  F  F  W  W  W  W  W  W  W  W  W  W  W  W  W  W  W  W  W  W  W  W
 F  F  F  F  W  W  W  W  W  W  W  W  W  W  W  W  W  W  W  W  W  W  W  W
 F  F  F  F  W  W  W  W  W  W  W  W  W  W  W  W  W  W  W  W  W  W  W  W
 F  F  F  F  W  W  W  W  W  W  W  W  W  W  W  W  W  W  W  W  W  W  W  W
 F  F  F  F  W  W  W  W  W  W  W  W  W  W  W  W  W  W  W  W  W  W  W  W
 F  F  F  F  W  W  W  W  W  W  W  W  W  W  W  W  W  W  W  W  W  W  W  W
 F  F  F  F  W  W  W  W  W  W  W  W  W  W  W  W  W  W  W  W  W  W  W  W
 F  F  F  F  W  W  W  W  W  W  W  W  W  W  W  W  W  W  W  W  W  W  W  W