_1 _1 _1 _1 _1 _1 _1 _1 _1 _1 _1 _1 _1 _1 _1 _1 _1 _1 _6 E6 _6 _1 _1 _1
_1 _6 _6 _6 _6 _6 _6 _6 _1 _6 _6 _6 _6 _6 _6 _6 _1 _6 _6 R6 _6 _6 C6 _1
_1 _6 _14 _6 _6 _6 _6 _6 _1 _6 _6 _6 _20 _6 _14 _6 _1 _6 _6 R6 _6 _6 _6 _1
_1 _6 _6 _6 _6 _6 _6 _6 _1 _6 _6 _6 _6 _6 _6 _6 _1 _6 _6 R6 _6 _6 _6 _1
_1 _6 _6 _6 _6 _6 _6 _6 _6 _6 _6 _6 _6 _6 _6 _6 _1 _6 _6 R6 _6 _6 _6 _1
_6 _6 _6 _6 _6 _6 _6 _6 _6 _6 _6 _6 _6 _6 _6 _6 _1 _6 _6 R6 _6 _6 _6 _1
_6 _6 _6 _6 _6 _6 _6 _6 _1 _6 _6 _6 _6 _6 _6 _6 _1 _6 _6 R6 _6 _6 _6 _1
_6 _6 _6 _6 _6 _6 _6 _6 _1 _6 _6 _6 _6 _6 _6 _6 _1 _6 _6 R6 _6 _6 _6 _1
S6 R6 R6 R6 R6 R6 R6 _6 _1 _6 _6 _6 _6 _6 _6 _6 _1 _6 _6 R6 _6 _6 _6 _1
_6 _6 _6 _6 _6 _6 R6 _6 _1 _1 _1 _1 _1 _1 _1 _1 _1 _6 _6 R6 _6 _6 _6 _1
_6 _6 _6 _6 _6 _6 R6 _6 _6 _6 _6 _6 _6 _6 _6 _6 _6 _6 _6 R6 _6 _6 _6 _1
_6 _6 _6 _6 _6 _6 R6 _6 _6 _6 _6 _6 _6 _6 _6 _6 _6 _6 _6 R6 _6 _6 _6 _1
_6 _6 _6 _6 _6 _6 R6 R6 R6 R6 R6 R6 R6 R6 R6 R6 R6 R6 R6 R6 _6 _6 _6 _1
_1 _6 _6 _6 _6 _6 _6 _6 _6 _6 _6 _6 M6 _6 _6 _6 _6 _6 _6 _6 _6 _6 _6 _1
_1 _6 _6 _6 _6 _6 _6 _6 _6 _6 _6 _6 _6 _6 _6 _6 _6 _6 _6 _6 _6 _6 _6 _1
_1 _6 _6 _6 _6 _6 _6 _6 _6 _6 _6 _6 _6 _6 _6 _6 _6 _6 _6 _6 _6 _6 _6 _1
_1 _6 _6 _6 _6 _6 _6 _6 _6 _6 _6 _6 _6 _6 _6 _6 _6 _6 _6 _6 _6 _6 _6 _1
_1 _1 _1 _1 _1 _1 _1 _1 _1 _1 _1 _1 _1 _1 _1 _1 _1 _1 _1 _1 _1 _1 _1 _1
